18 18
1 1 1 1 1 1 1 0 0 0 0 1 1 1 1 1 1 1
1 1 1 1 1 1 1 0 0 2 0 1 1 1 1 1 1 1
1 1 1 1 1 1 1 0 0 0 0 1 1 1 1 1 1 1
1 1 1 1 1 1 1 0 2 0 0 1 1 1 1 1 1 1
1 1 1 1 1 1 1 0 0 0 0 1 1 1 1 1 1 1
1 1 1 1 1 1 1 0 0 0 0 1 1 1 1 1 1 1
1 1 1 2 1 2 1 0 0 0 0 1 1 2 1 1 1 1
0 0 0 0 2 0 0 0 0 0 0 0 0 0 0 0 0 0
0 0 0 0 0 0 0 0 0 0 0 0 0 0 0 0 0 0
0 0 0 0 0 0 0 0 0 2 0 0 0 0 0 0 0 0
0 0 0 0 0 0 0 0 0 2 0 0 0 0 0 0 0 0
1 2 1 1 1 1 1 0 0 0 0 1 1 1 0 1 1 1
1 1 1 1 1 1 1 0 0 0 0 1 1 1 2 1 1 1
1 1 1 1 1 1 1 0 2 0 0 1 1 1 1 1 1 1
1 1 1 1 1 1 1 0 2 0 0 1 1 1 1 1 1 1
1 1 1 1 1 1 1 2 0 0 0 1 1 1 1 1 1 1
1 1 1 1 1 1 1 2 0 0 0 1 1 1 1 1 1 1
1 1 1 1 1 1 1 0 0 0 0 1 1 1 1 1 1 1
Sign 5 6
Building 14 12
Car 7 15
Car 8 14
Car 9 10
Corpse 8 3
Corpse 9 1
Kiosk 1 11
Kiosk 3 6
Kiosk 13 6
Robot 4 7