18 18
1 1 1 1 1 1 1 0 0 0 0 1 1 1 1 1 1 1
1 1 1 1 1 1 1 0 0 0 0 1 1 1 1 1 1 1
1 1 1 1 1 1 1 0 0 0 0 1 1 1 1 1 1 1
1 1 1 1 1 1 1 0 0 0 0 1 1 1 1 1 1 1
1 1 1 1 1 1 1 0 0 0 0 1 1 1 1 1 1 1
1 1 1 1 1 1 1 0 0 0 2 1 1 1 2 1 1 1
1 1 2 1 1 2 1 0 0 0 2 1 1 1 0 1 1 1
0 0 0 0 0 0 0 0 2 0 0 0 0 0 0 2 0 0
0 0 0 0 0 2 0 0 0 2 0 0 0 0 0 0 0 0
0 0 0 0 0 0 0 0 2 0 0 0 0 0 0 0 0 0
0 0 0 0 0 0 0 0 0 2 0 0 0 0 0 0 0 0
1 1 1 1 1 1 1 0 0 2 0 1 1 1 0 1 1 1
1 1 1 1 1 1 1 0 2 0 0 1 1 1 2 1 1 1
1 1 1 1 1 1 1 0 2 0 0 1 1 1 1 1 1 1
1 1 1 1 1 1 1 0 0 0 0 1 1 1 1 1 1 1
1 1 1 1 1 1 1 0 0 0 0 1 1 1 1 1 1 1
1 1 1 1 1 1 1 0 0 0 0 1 1 1 1 1 1 1
1 1 1 1 1 1 1 0 0 0 0 1 1 1 1 1 1 1
Sign 5 6
Building 14 5
Building 14 12
Car 8 12
Car 9 11
Car 10 6
Corpse 8 7
Corpse 8 9
Corpse 9 8
Trashcan 2 6
Trashcan 5 8
Trashcan 15 7