18 18
1 1 1 1 1 1 1 0 0 0 0 1 1 1 1 1 1 1
1 1 1 1 1 1 1 0 0 0 0 1 1 1 1 1 1 1
1 1 1 1 1 1 1 0 0 0 0 1 1 1 1 1 1 1
1 1 1 1 1 1 1 0 0 0 0 1 1 1 1 1 1 1
1 1 1 1 1 1 1 0 0 2 0 1 1 1 1 1 1 1
1 1 1 2 1 1 1 0 0 2 0 1 1 1 2 1 1 1
1 1 1 0 1 2 1 0 0 0 0 1 1 1 0 1 1 1
0 0 0 0 0 0 0 2 0 0 0 0 0 0 0 0 0 0
0 0 0 0 0 0 0 2 0 0 0 0 2 0 0 0 0 0
0 0 0 0 0 0 0 0 0 2 0 0 0 0 0 0 0 0
0 0 0 0 2 0 0 0 0 0 0 0 0 0 0 0 0 0
1 1 1 1 1 2 1 0 2 0 0 1 1 2 1 1 1 1
1 1 1 1 1 1 1 0 2 0 0 1 1 1 1 1 1 1
1 1 1 1 1 1 1 0 0 2 0 1 1 1 1 1 1 1
1 1 1 1 1 1 1 0 0 0 0 1 1 1 1 1 1 1
1 1 1 1 1 1 1 0 0 0 0 1 1 1 1 1 1 1
1 1 1 1 1 1 1 0 0 0 2 1 1 1 1 1 1 1
1 1 1 1 1 1 1 0 0 0 0 1 1 1 1 1 1 1
Sign 5 6
Building 3 5 
Building 14 5
Car 7 7
Car 8 12
Car 9 5
Corpse 9 9
Corpse 10 16
Kiosk 5 11
Kiosk 13 11
Robot 4 10
Robot 9 13
Robot 12 8