18 18
1 1 1 1 1 1 1 0 0 0 0 1 1 1 1 1 1 1
1 1 1 1 1 1 1 0 0 0 0 1 1 1 1 1 1 1
1 1 1 1 1 1 1 2 0 0 0 1 1 1 1 1 1 1
1 1 1 1 1 1 1 0 0 0 0 1 1 1 1 1 1 1
1 1 1 1 1 1 1 0 0 0 0 1 1 1 1 1 1 1
1 1 1 2 1 1 1 0 0 0 0 1 1 1 1 1 1 1
1 1 1 0 1 2 1 0 0 0 0 1 1 1 1 1 1 1
0 0 0 0 0 0 0 0 0 2 0 0 0 0 0 0 0 0
0 2 0 0 0 0 0 0 0 2 0 0 2 0 0 0 0 0
0 0 0 0 2 0 0 0 0 0 0 0 0 0 0 2 0 0
0 0 0 0 0 0 0 0 0 0 0 0 0 2 0 2 0 0
1 1 1 0 1 1 1 0 0 0 0 1 1 1 1 1 1 1
1 1 1 2 1 1 1 0 0 0 0 1 1 1 1 1 1 1
1 1 1 1 1 1 1 0 0 0 0 1 1 1 1 1 1 1
1 1 1 1 1 1 1 0 0 2 0 1 1 1 1 1 1 1
1 1 1 1 1 1 1 0 2 0 0 1 1 1 1 1 1 1
1 1 1 1 1 1 1 0 2 0 0 1 1 1 1 1 1 1
1 1 1 1 1 1 1 0 0 0 0 1 1 1 1 1 1 1
Sign 5 6
Building 3 5
Building 3 12
Car 8 15
Car 9 8
Car 15 10
Corpse 1 8
Corpse 9 14
Corpse 13 10
Robot 4 9
Robot 7 2
Robot 12 8