18 18
1 1 1 1 1 1 1 0 0 0 0 1 1 1 1 1 1 1
1 1 1 1 1 1 1 0 0 0 0 1 1 1 1 1 1 1
1 1 1 1 1 1 1 0 0 0 0 1 1 1 1 1 1 1
1 1 1 1 1 1 1 0 0 0 0 1 1 1 1 1 1 1
1 1 1 1 1 1 1 0 0 0 0 1 1 1 1 1 1 1
1 1 1 1 1 1 1 0 0 0 0 1 1 1 1 1 1 1
1 1 1 1 1 2 1 0 0 0 0 1 1 1 1 1 1 1
0 0 0 0 0 2 0 0 0 0 2 0 0 0 0 0 0 0
0 0 0 0 2 0 0 0 2 0 0 0 0 0 0 0 0 0
0 0 0 0 2 0 0 0 0 2 0 0 0 2 0 0 0 0
0 0 0 0 0 0 2 0 2 0 0 0 0 2 0 0 2 0
1 1 1 0 1 1 1 0 0 0 0 1 1 1 1 2 1 1
1 1 1 2 1 1 1 2 0 0 0 1 1 1 1 1 1 1
1 1 1 1 1 1 1 2 0 0 0 1 1 1 1 1 1 1
1 1 1 1 1 1 1 0 0 0 0 1 1 1 1 1 1 1
1 1 1 1 1 1 1 0 0 0 0 1 1 1 1 1 1 1
1 1 1 1 1 1 1 0 0 0 0 1 1 1 1 1 1 1
1 1 1 1 1 1 1 0 0 0 0 1 1 1 1 1 1 1
Sign 5 6
Building 3 12 
Car 4 8
Car 7 12
Car 13 10
Corpse 8 8
Corpse 9 9
Corpse 16 10
Kiosk 15 11
Robot 5 7
Robot 6 10
Trashcan 8 10
Trashcan 10 7