18 18
1 1 1 1 1 1 1 0 0 0 0 1 1 1 1 1 1 1
1 1 1 1 1 1 1 0 0 0 0 1 1 1 1 1 1 1
1 1 1 1 1 1 1 0 0 0 0 1 1 1 1 1 1 1
1 1 1 1 1 1 1 0 0 0 0 1 1 1 1 1 1 1
1 1 1 1 1 1 1 0 0 0 0 1 1 1 1 1 1 1
1 1 1 2 1 1 1 0 0 0 0 1 1 1 2 1 1 1
1 1 1 0 1 2 1 0 0 0 0 1 1 1 0 1 1 1
0 0 0 0 0 0 0 0 0 0 0 0 0 2 0 0 0 0
0 2 0 2 0 0 0 0 0 0 0 0 0 2 0 0 0 0
0 2 0 0 0 2 0 0 0 0 2 0 0 0 0 0 0 0
0 0 0 0 0 0 0 0 0 0 0 0 2 0 0 0 0 0
1 1 1 1 2 1 1 0 0 2 0 1 1 1 1 1 1 1
1 1 1 1 1 1 1 0 0 0 0 1 1 1 1 1 1 1
1 1 1 1 1 1 1 0 0 0 0 1 1 1 1 1 1 1
1 1 1 1 1 1 1 0 0 0 0 1 1 1 1 1 1 1
1 1 1 1 1 1 1 0 0 0 0 1 1 1 1 1 1 1
1 1 1 1 1 1 1 0 2 0 0 1 1 1 1 1 1 1
1 1 1 1 1 1 1 0 0 0 0 1 1 1 1 1 1 1
Sign 5 6
Building 3 5 
Building 14 5
Car 1 8
Car 13 7
Corpse 5 9
Kiosk 4 11
Robot 3 8
Robot 9 11
Robot 10 9
Trashcan 8 16
Trashcan 12 10