18 18
1 1 1 1 1 1 1 0 0 0 0 1 1 1 1 1 1 1
1 1 1 1 1 1 1 0 0 0 0 1 1 1 1 1 1 1
1 1 1 1 1 1 1 0 0 2 0 1 1 1 1 1 1 1
1 1 1 1 1 1 1 0 0 0 0 1 1 1 1 1 1 1
1 1 1 1 1 1 1 0 0 2 0 1 1 1 1 1 1 1
1 1 1 2 1 1 1 0 0 2 0 1 1 1 1 1 1 1
1 1 1 0 1 2 1 0 0 0 0 1 2 1 1 2 1 1
0 0 0 0 0 0 0 0 0 0 0 0 0 0 0 0 0 0
0 2 0 0 2 0 2 0 0 0 0 0 0 0 0 0 0 0
0 0 0 0 2 0 0 0 2 0 0 0 0 0 0 0 0 0
0 0 0 0 0 0 0 0 0 0 0 0 0 2 0 0 0 0
1 1 1 1 1 1 1 0 0 0 0 1 1 1 0 1 1 1
1 1 1 1 1 1 1 0 0 0 0 1 1 1 2 1 1 1
1 1 1 1 1 1 1 0 0 0 0 1 1 1 1 1 1 1
1 1 1 1 1 1 1 0 0 0 0 1 1 1 1 1 1 1
1 1 1 1 1 1 1 0 0 2 0 1 1 1 1 1 1 1
1 1 1 1 1 1 1 0 0 2 0 1 1 1 1 1 1 1
1 1 1 1 1 1 1 0 0 0 0 1 1 1 1 1 1 1
Sign 5 6
Building 3 5
Building 14 12
Car 4 8
Car 9 4
Car 9 15
Corpse 1 8
Corpse 9 2
Corpse 13 10
Kiosk 12 6
Kiosk 15 6
Robot 6 8
Robot 8 9