18 18
0 1 1 1 1 1 0 0 0 0 1 1 1 1 0 0 0 0
0 1 1 1 1 1 0 0 0 0 1 1 1 1 0 0 0 0
0 1 1 1 1 1 0 0 0 0 1 1 1 1 0 0 0 0
0 1 1 1 1 1 0 0 0 0 1 1 1 1 0 0 0 0
0 1 1 1 1 1 0 0 0 0 1 1 1 1 0 0 0 0
0 1 1 1 1 1 0 0 0 0 1 1 1 1 0 0 0 0
0 1 1 1 1 1 0 0 0 0 1 1 1 1 0 0 0 0
0 1 1 1 1 1 0 0 0 0 1 1 1 1 0 0 0 0
0 1 1 1 1 1 0 0 0 0 1 1 1 1 0 0 0 0
0 1 0 0 0 0 1 0 0 0 0 0 0 0 1 0 0 0
0 1 0 0 0 0 1 0 0 0 0 0 0 0 1 0 0 0
0 0 0 0 0 0 0 1 0 0 0 0 0 0 0 1 0 0
1 1 0 0 1 0 0 0 0 1 0 0 1 0 0 0 0 1
0 1 1 1 1 1 0 0 0 0 1 1 1 1 0 0 0 0
0 1 1 1 1 1 0 0 0 0 1 1 1 1 0 0 0 0
0 1 1 1 1 1 0 0 0 0 1 1 1 1 0 0 0 0
0 1 1 1 1 1 0 0 0 0 1 1 1 1 0 0 0 0
0 1 1 1 1 1 0 0 0 0 1 1 1 1 0 0 0 0
Car 3 10
Trashcan 9 0
Corpse 3 12