18 18
1 1 1 1 1 1 1 0 0 0 0 1 1 1 1 1 1 1
1 1 1 1 1 1 1 0 0 0 0 1 1 1 1 1 1 1
1 1 1 1 1 1 1 0 0 2 0 1 1 1 1 1 1 1
1 1 1 1 1 1 1 0 0 0 0 1 1 1 1 1 1 1
1 1 1 1 1 1 1 0 2 0 0 1 1 1 1 1 1 1
1 1 1 2 1 1 1 0 2 0 0 1 1 1 1 1 1 1
1 1 1 0 1 2 1 0 0 0 0 1 1 1 1 2 1 1
0 0 0 0 0 0 0 0 0 0 0 0 0 2 0 0 0 0
0 0 0 0 2 0 0 0 2 0 0 0 0 2 0 0 0 0
0 0 0 0 0 0 0 0 0 2 0 0 0 0 0 0 0 0
0 0 0 0 0 0 0 2 0 0 0 0 0 0 0 0 0 0
1 1 1 0 1 1 1 2 0 0 0 2 1 2 1 1 1 1
1 1 1 2 1 1 1 0 0 0 0 1 1 1 1 1 1 1
1 1 1 1 1 1 1 0 0 0 0 1 1 1 1 1 1 1
1 1 1 1 1 1 1 0 0 0 0 1 1 1 1 1 1 1
1 1 1 1 1 1 1 0 0 0 2 1 1 1 1 1 1 1
1 1 1 1 1 1 1 0 0 0 0 1 1 1 1 1 1 1
1 1 1 1 1 1 1 0 0 0 0 1 1 1 1 1 1 1
Sign 5 6
Building 3 5
Building 3 12
Car 7 10
Car 8 5
Car 13 8
Corpse 8 8
Corpse 9 2
Corpse 10 15
Kiosk 13 12
Kiosk 15 6
Trashcan 4 8
Trashcan 9 9
Trashcan 11 11